311111111111111111111111111111111111111111111111111111111111
111111111111111111111111111111111111111111111111111111111111
111111111111111111111111111111111111111111111111111111111111
111111111111111111111111111111111111111111111111111111111111
111111111111111111111111111111110000411111111111111111111111
111111111111111111111111111114411111141111111111111111111111
111114411111111111111110011111111111114111111111111111111111
111141141111144011111111111111111111111411111144111111441111
211111111111111111111111111111111111111141111111111111111113
000000000001100000000000001100000110001100000011000000110000
