11111111111111111111111111111111111111111111111111
11111111111111111111111111111111111111111111111111
11111111111111111111111111111111111111111111111111
11111111111111111111111111411111111111111111111111
11111111111111111111111100141111111111111111111111
11111111111111111111001111114111111111111111111111
11114411441111100111111111111411111111111111111111
11111111111111111111111111111141114411441114411111
21111111111111111111111111111114111111111111111113
00000000110000000000011000001100001100110001100000
