00000002000000000000
00111111111000000000
00100000001111111000
00101111100000001000
01101000100000111000
01000011111111001000
01111110100001001000
01000100101111001000
01000100111000001000
01110100001111111000
00100100000000010000
00100111111111110000
11100100000000010000
10000100111111111110
01111101100000000010
01000001000000000110
01100001111110001100
00111111000010001000
00100000000011111000
00000000000030000000
